1
__##_##_##_##___#_###
_______#_#_####_#____
#_______#_____#___#__
###_____1__##__#____#
_!____#___#______#___