__##_##_##_##___#_###
_______#_#_####_#____
#_______#_____#___#__
###_____1__##__#____#
_G____#___#______#___