__##_##_##_##___#_###
_______#_#_####_#____
#_______#_____#___#__
###________##__#____#
_G____#___#______#___